##################################
#            #      #            #
# ##### # ##   ####   ## # ##### #
#       # ####  ##  #### #       #
# ##### #    #      #    # ##### #
# ##### # ## # #### # ## # ##### #
# ##### #  #   ####   #  # ##### #
#       ## # #      # # ##       #
####### ## # #  ##  # # ## #######
#          # ######## #          #
# ####### #            # ####### #
#         # ########## #         #
##################################
